Misha	Khan
Kayonna	Tindle
Terell	Dale
Hunter	Luber
Christina	Holmgren
Daniel	Lee
Tyler	Soutendijk
Colin	Perkins-Taylor
Mehra	denBraven
Danielle	Ledford
Bingxin	Tu
Jiung	Jung
Adora	Zhang
Pei Yi	Mei
Thibault	Vernier
Vitor	DosAnjos
Ankur	Malik
Alyssa	Ogle
Ayodeji	George
Vir	Shetty
Rachel	Choe
Noah	Criss
Jason	Kim
Wen	Seng
Major	Eason
Harry	Yeung
Alexandra	Comaniciu
Jaxson	Freund
Jose	Valdivia
